abstract	                    摘要  adj. 抽象的，纯概念的；（艺术）抽象派的；理论上的，不切实际的 n. 摘要，梗概；抽象画，抽象派艺术作品；抽象的概念 v. 抽象化，从理论上（或孤立地）考虑；提取，使分离；写……的摘要；偷走，窃取；退出  复数: abstracts 过去式: abstracted 比较级: more abstract 最高级: most abstract 现在分词: abstracting 过去分词: abstracted 第三人称单数: abstracts
account Name	                帐户名称  账户名称：用于识别和访问特定账户的唯一名称，通常用于在线服务、银行账户等。
account Number	                帐号  [会计] 帐号
Add	                            添加  v. 添加，掺入；（使）相加，加；增加；增添（某种特性）；把……计算在内，包括；补充说，继续说 abbr. 注意力缺陷障碍，多动症（ADD）
address	                        地址  n. 地址，住址；网址；电子邮箱地址；演讲，演说；（电子表格中某个单元格的）位置；<古>（对他人的）谈吐；<古>谦恭（或脉脉含情）的方式；<旧>机敏，迅速；位置存储编码 v. 演说，演讲；处理，设法解决；在（信封、包裹等）上写姓名和地址，致函；<正式> 向……讲话；称呼；<正式>（向某人）提出（陈述、投诉等）；（高尔夫）就位击（球）  复数: addresses 过去式: addressed 现在分词: addressing 过去分词: addressed 第三人称单数: addresses
ADMIN	                        管理  n. <非正式>行政，管理（=administration）
allow Getters	                允许getter
amount	                        量  n. 数量，量；金额，钱数；（感情、质量的）程度 v. 达到，总计（amount to）；等于，意味着（amount to）；发展成，变成（amount to）  复数: amounts 过去式: amounted 现在分词: amounting 过去分词: amounted 第三人称单数: amounts
ANONYMOUS	                    匿名  adj. 匿名的，不知名的；不记名的，不具名的；无特色的
Application	                    应用程序  n. 正式申请，书面申请；申请书，申请表；敷用，涂抹；应用，实施；指称；应用软件；勤奋，努力  复数: applications
Area	                        区域  n. 地区，区域；场地，地方；领域；面积；部位；罚球区 【名】 （Area）（西）阿雷亚（人名）  复数: areas
area Code	                    区号  区号：电话号码中表示特定地理区域的一部分，通常在电话号码的开头。
area Name	                    区域名称  域名
asc	asc                         abbr. 美国安全委员会（American Security Council）；美国电影摄影师协会（American Society of Cinematographers）；自动稳定控制（automatic stability control）；美国标准委员会（American Standards Committee）；会计准则委员会（Accounting Standards Committee）
Audit	                        审计 vi. （Audit）（印）奥特（人名） n. （audit）审计；（质量或标准的）审查；（系统的）调查 v. （audit）对（公司或其账目）进行财务审查；旁听（大学课程）；系统检查
audit Seller	                审核卖方
Audit Status	                审计的地位  审核状态
auth Type	                    身份验证类型
AUTHORIZATION	                授权  n. 批准书，授权书；批准，授权  复数: authorizations
Bank Account	                银行账户  银行账户：一个由银行为客户提供的用于存储和管理资金的账户。
bank Card No	                银行卡号码
bank Log Type	                银行日志类型
banner	                        横幅  n. 横幅标语；（网页上的）横幅广告；信仰，准则；旗帜 adj. 极好的，出色的 v. 在（头版的）通栏大字标题下刊登（新闻报道等） 【名】 （Banner）（英、德、罗）班纳（人名）  复数: banners 过去式: bannered 现在分词: bannering 过去分词: bannered 第三人称单数: banners
boolean	                        布尔  adj. 布尔数学体系的
break	                        打破  v. 打破，打碎，折断；（人或动物）骨折；（使）（表层、盖子或密封）破裂，撕开；割破，擦破（皮肤）；打破（纪录）；得分（低于或高于规定总分）；超过；打断，打破（沉默）；结束（困难或不利局面），打破（僵局）；断绝，中断（关系）；使……放弃习惯；切断（电路）；（使）（工具或机器）损坏；破坏，违反（规则、承诺或协议）；稍停，休息；（旅行时）停顿，停留；突破，挣脱；瓦解……的决心，垮掉；使心碎；驯化，驯服；摧毁（一个组织）；（新闻或丑闻）突然传开；（婉转地）透露，说出（坏消息）；首次发表，首次播出；（波浪）拍岸，迸溅；（男孩嗓音）变粗；（因强烈的情绪）声调突变；（元音）发生割裂而变成双元音；破晓；（云）散开；（天气）突变，（风暴）骤起；破解，破译（密码）；兑开（纸币）；减缓；（网球中）破发球；（球）转向，曲线飞行；开球破局；（尤指拳击手或摔跤手在裁判下令后）分开，抱持后拆散；展开（旗帜或船帆）；证明（不在犯罪现场的辩护）不实；（股价）暴跌；（体育比赛或军队作战时攻方）出击，猛冲；开始快跑；溃败；发生，发展；（热度）降低，退烧 n. 裂缝，缺口；骨折，骨折处；停顿，暂停；间歇，小憩；课间休息；（电台或电视节目）插播广告的间隙；短假；机会，机遇；结束，断绝；（因情感作用）嗓音突变；<文>黎明，破晓；天气突变；破发，破发球局得分；连击所得的分数；（球的）弧线飞行，曲线飞行；开局；切断（电路）；（尤指球员或球队）进攻；逃跑（尤指越狱）；（对某人或某团体）有帮助的事物；芽，蓓蕾；换行，换段，换页；（爵士或流行音乐中的）独奏（或器乐演奏）短段；碎拍舞曲（breaks）；双轮驱马大车（breaking cart 的原称）；<史>敞篷四轮马车（同 brake）  复数: breaks 过去式: broke 现在分词: breaking 过去分词: broken 第三人称单数: breaks
business Scope	                业务范围  经营范围：指企业在其注册资本范围内从事的各类经营活动。
buyer	                        买家  n. 买主；采购员 n. （Buyer）人名；（英）拜尔；（法）比耶；（德）布耶尔  复数: buyers
buyer Name	                    买家的名字
Cache	                        缓存  n. 隐藏处，秘窖；贮藏物，隐藏物（尤指武器）；高速缓冲存储器 v. 匿藏，隐藏（尤指武器）；把（数据）存入高速缓冲存储器；给（硬件）装备高速缓存  复数: caches 过去式: cached 现在分词: cacheing, caching 过去分词: cached 第三人称单数: caches
Cache Concurrency Strategy	    缓存并发策略
caller	                        调用者  n. 访客；[通信]呼叫者；打电话者；召集员 adj. 新鲜的 n. （Caller）人名；（西）卡列尔  复数: callers
case	                        情况下  n. 具体情况，实例；病例，病案；诉讼，官司；案件，案子；容器，箱子；事实，论据；（特定处境或品性的）人；（语法的）格 v. 围绕，包盖；（盗抢前）探察，踩点儿；装入保护容器内 【名】 （Case）（英）凯斯，（西）卡塞，（法）卡斯（人名）  复数: cases 过去式: cased 现在分词: casing 过去分词: cased 第三人称单数: cases
catch	                        抓  v. 接住；抓住，捉住；扶住（要倒的人）；逮住，捕获；（尤指设置陷阱）捕捉；撞见（某人）犯罪（或做错事）；（被）钩住，（被）绊住；击中，触到（某人或某物）；被击中；患（病）；引起，吸引（注意或兴趣）；（对某事）感到兴奋，感兴趣；赶（公共汽车、火车等）；及时做（或谈等）；出席，观看（演出）；表现，象征着；使（某人）措手不及；察觉，瞥见；听清楚，领会；忽然发觉，突然意识到；赶上，追上（某人）；接（水）；（板球）使（击球手）被接杀出局；（棒球比赛中）充当接球手；（光）照射于，受（光）照射；（风或水）裹挟，推动；着火，燃烧；（引擎）发动，点火；遭遇，陷入（困境）；使进退两难；中止，打住；致使（某人）被制止，延误；固定，系牢；被（悬浮物）覆盖；做（某事），拥有（某事物）；争取到 n. 接住，截住（某物，尤指球）；（鱼的）捕获量，捕获物；<旧>理想的丈夫（或妻子），合适的合作伙伴；搭扣，把手，门闩；（声息）哽塞；隐患，隐藏的困难；（板球）接杀；（乐）（尤指为达到幽默效果的）轮唱片段；捉人游戏；传接球游戏  复数: catches 过去式: caught 现在分词: catching 过去分词: caught 第三人称单数: catches
class	                        类  n. 班级；（一节）课，上课时间；（某一科目的）课程；阶级，阶层；等级划分，等级制度；（货物、服务或人的）等级，类别；（飞机、火车等的）舱位等级，车厢等级；品味；同届毕业生；<英>（英国大学的）学位等级；（生物）（植物或动物分类的）纲；（比赛的）组别 v. 把……归类，把……看作；把……编入某一班级；属于……类（或等级），被列为某类（或某级） adj. <非正式>优秀的，出色的 【名】 （Class）（英、德）克拉斯（人名）  复数: classes 过去式: classed 现在分词: classing 过去分词: classed 第三人称单数: classes
code	                        代码  n. 密码，暗码；（邮政）编码，（电话）区号；（计算机）编码；道德准则，行为规范；法典，法规 v. 把……编码（或编号）；把……译成密码；（给计算机）编写指令 【名】 （Code）（英、法、西）科德（人名）  复数: codes 过去式: coded 现在分词: coding 过去分词: coded 第三人称单数: codes
Column	                        列  n. 圆柱，纪念柱；柱状物；纵队，纵行（列）；（报纸、杂志上的）栏；（报纸或杂志的）专栏（文章）  复数: columns
COMPANY	                        公司  n. 公司；陪伴，同伴；宾客，来宾；在一起的一群人；连队；剧团，歌舞团；女童军大队 v. <古>结交，交往；<古>陪伴 【名】 （Company）（美、瑞）孔帕尼（人名）  复数: companies 过去式: companied 现在分词: companying 过去分词: companied 第三人称单数: companies
company Name	                公司名称  公司名称；注册之公司名称
configure	                    配置  v. 安装，装配；（计算机）配置，设定  过去式: configured 现在分词: configuring 过去分词: configured 第三人称单数: configures
Confirmed	                    确认  adj. 坚定的，根深蒂固的；已被证实的 v. 确定；证实；使确信（confirm 的过去式和过去分词形式）
contact Person	                联系人  联系人：一个在某个组织或公司中负责处理特定事务或问题的人，可以作为沟通的桥梁。
content	                        内容  adj. 满足的，满意的，甘愿的 n. 目录；所含物，容纳的东西；（书、文章、演讲、电影等的）内容；含量；满足，满意；投赞成票的贵族院议员；网上信息，电子信息 v. 使满意，使满足 【名】 （Content）（法）孔唐（人名）  复数: contents 过去式: contented 比较级: more content 最高级: most content 现在分词: contenting 过去分词: contented 第三人称单数: contents
Contract	                    合同  n. （美）孔塔克特（人名） n. （contract）合同，协议；契约；婚约；（非正式）雇用刺客的暗杀协议；（桥牌）定约 v. （contract）使收缩，使缩小，使缩短；感染；订约，签订；结交；负（债）；招致 adj. （contract）受雇执行合同的，雇用的
create Time	                    创建时间  创建时间：指某个文件、项目或其他事物被创建的具体时间。
Created By	                    由  由......创建：表示某个作品、项目或产品是由某个人或团队创作或制作的。
Created Date	                创建日期
credit Code	                    信用代码  信用代码：一种用于识别企业信用的唯一代码，通常由数字和字母组成，用于金融和商业交易中。
debug	                        调试  vt. 调试；除错，改正有毛病部分；[军] 除去窃听器  复数: debugs 过去式: debugged 现在分词: debugging 过去分词: debugged 第三人称单数: debugs
default	                        默认的  n. 不履行，违约；默认，系统设定值；缺席，弃权 v. 违约，不履行义务；默认，预设；弃权，未到场 adj. 默认的  复数: defaults 过去式: defaulted 现在分词: defaulting 过去分词: defaulted 第三人称单数: defaults
desc	                        desc  abbr. 降序排列（descend 的缩写）；美国国防电子器材供应中心（The Defense Energy Support Center）
description	                    描述  n. 描述，形容，说明；类型  复数: descriptions
disclaimer	                    免责声明  n. 不承诺，免责声明；放弃，拒绝  复数: disclaimers
disclaimer Signed	            签署免责声明
display Order	                显示顺序  显示顺序：指在计算机屏幕、网页或其他视觉界面上排列和展示信息的顺序。
Edit	                        编辑  n. （Edit）（匈）埃迪特（人名） v. （edit）编辑；剪辑（影片等）；主编；编校 n. （edit）编辑，校订
else	                        其他的  adv. 此外，其他；否则，要不然 adj. 其他的，另外的 【名】 （Else）（英）埃尔斯，（德）埃尔泽，（芬、丹）埃尔塞（人名）
email	                        电子邮件  n. 电子邮件（通信方式）；电子邮件 v. 给（某人）发电子邮件 【名】 （Email）（法）埃马伊（人名）
end Time	                    结束时间  结束时间：指某个活动、事件或过程的终止时刻。
ENTERPRISE	                    企业  n. 企业，事业单位；事业心，进取心；事业；创业，企业经营  复数: enterprises
Entity	                        实体  n. 实体，独立存在体  复数: entities
Entity Listeners	            实体的听众
enum	                        枚举  n. 枚举，列举型别；电话号码映射
Enumerated	                    枚举  v. 枚举；点，数（enumerate 的过去式及过去分词）
equals	                        =  n. 对手；（地位、实力等）相同或相等的人；相等物（equal 的复数） v. 平等；比得上；与......相同；引起，造成（equal 的第三人称单数）
error	                        错误  n. 错误，差错；（棒球、网球等运动中的）失误  复数: errors
Esign Log	                    结果日志
Exception	                    异常  n. 例外，除外  复数: exceptions
expired	                        过期的  adj. 过期的；失效的 v. 期满；失效；（人）死亡；呼（气）（expire 的过去式和过去分词）
extends	                        扩展  v. 延伸；扩充；继承（extend 的第三人称单数形式）
Factory	                        工厂  n. 工厂，制造厂；（在外国的）代理店  复数: factories
false	                        假  adj. 错误的，不真实的；伪造的；人造的；站不住脚的，全无根据的；不真诚的；不忠诚的；外表上与……相似的；非法的；妄动的 adv. 欺诈地  比较级: falser 最高级: falsest
fax	                            传真  n. 传真机；传真信件；传真 v. 传真（文档、信件等）；用传真与（某人）联系 【名】 （Fax）（美、瑞、巴、德）法克斯（人名）
Files	                        文件  n. [计]文件；[图情][计]文档（file 的复数） v. 提出（file 的第三人称单数）；发送；汇订 n. （Files）人名；（英）法尔斯；（法）菲勒
Filter	                        过滤器  n. （Filter）（美）菲尔特（人名） v. （filter）滤过；渗入；慢慢传开；过滤；渗透；用过滤法除去 n. （filter）滤波器；过滤器；筛选；滤光器
final	                        最后  adj. 最终的，结束的；(出现次序)最后的，末尾的；决定性的，不可变更的；无比的，极度的 n. 决赛；期末考试，课程终结考试；主调音；当日报纸的末版；（飞机进入着陆跑道的）最终边，第五边  复数: finals
first Name	                    第一个名字  名字：一个人姓名的第一部分，通常用于表示个人，与姓氏相对。
freezed	                        冻结  v. 冷冻；结冰；冻结（freeze 的过去分词）
freezed Reason	                冻结的原因
Generated Value	                生成的值
Generation Type	                代型  生成类型：指计算机程序或算法生成数据或内容的方式。 · The AI model uses a specific generation type to create realistic images. 该AI模型使用特定的生成类型来创建逼真的图像。
GOVERNMENT	                    政府  n. 政府，内阁；政体，国家体制；（国家等的）治理，管理；政府掌控经济和社会活动的程度；（语法）支配关系  复数: governments
id Card Back	                身份证背面
id Card Front	                身份证正面
IDENTITY	                    身份  n. 身份，本体；个性，特性；同一性，一致；恒等运算，恒等式  复数: identities
if	                            如果  conj. （表条件）如果；（表假设）要是，假如；无论何时；虽然，即使；（用于间接疑问）是否；（用于礼貌问询）是否；当，每次；（与情态动词连用）表婉转客气；这不是……，要是……多好；或许不；就算；尽管 n. 条件，设想；不确定的情况
images	                        图片  n. 图像；影像；肖像；想像（image 的复数） v. 作……的像；描绘……的形象；幻想（image 的第三人称单数）
implements	                    实现了  n. 工具；器具；用具；家具；服装；装备；手段；充当工具的人；【法律】履行(契约等) vt. 执行，履行；贯彻，落实；使生效
import	                        进口  n. 进口，进口商品；输入，引进；重要性；意思，含意 v. 进口，输入，引进；导入（计算机）；<旧>意味，表明  复数: imports 过去式: imported 现在分词: importing 过去分词: imported 第三人称单数: imports
index	                        指数  n. 索引；（物价和工资等）指数；指标，量度；幂，根指数；指针 v. 为……编索引，将……编入索引；使指数化，将（工资）等与（物价水平等）挂钩；（机器，部件）转位  复数: indexes, indices 过去式: indexed 现在分词: indexing 过去分词: indexed 第三人称单数: indexes
Info	                        信息  n. 信息；情报
Institution Type	            机构类型
int	int                         abbr. 整数，中断；国际组织（International organizations）
Integer	                        整数  n. 整数；完整物，统一体  复数: integers
interface	                    接口  n. （人机）界面（尤指屏幕布局和菜单）；（计算机设备之间的）连接，接口；（物理）界面；（学科或系统间相互影响或衔接的）边缘区域，接合部位 v. （通过界面或接口）连接；相互联系，相互交流（interface with）  复数: interfaces 过去式: interfaced 现在分词: interfacing 过去分词: interfaced 第三人称单数: interfaces
issuing Bank	                开证行  发卡银行：发行信用卡或借记卡的金融机构。
Json Ignore Properties	        Json忽略属性
land Line	                    陆线  固定电话：一种通过固定的电缆或光纤传输语音和数据的电话系统。
Last Modified By	            最后修改人
Last Modified Date	            最后修改日期
last Name	                    姓  姓氏：一个人名字的一部分，通常用于表示家族关系或血统，位于名字的开头或结尾。
latitude	                    纬度  n. 纬度；纬度地区；选择的自由，回旋余地；（感光乳剂，相纸）曝光宽容度  复数: latitudes
length	                        长度  n. 长，长度；（持续）时间的长短；（书或文件等的）篇幅，（电影的）片长；（游泳池的）池长；（马或船的）自身长度；（行动的）程度；细长的一段（根，条）；（头发、衣服等）到身体某部位的长度；手中牌长（多指五张以上某同花牌）；（板球）球距；（元音或音节的）节奏音长  复数: lengths
license	                        许可证  n. 执照，许可证；特许（同 licence） vt. 许可；特许；发许可证给  复数: licenses 过去式: licensed 现在分词: licensing 过去分词: licensed 第三人称单数: licenses
link Url	                    链接网址
List	                        列表  n. 列表，清单；（船）倾侧；围栏；赛场，战场；（织物的）镶边；<旧>渴望，喜好；（尤指按重要程度排列的）事物清单 v. 列清单，拟订清单；把……列入名单；（使）（公司）上市；标价；（船）倾斜；<旧>征召（士兵）；<旧>想要，喜好  复数: lists 过去式: listed 现在分词: listing 过去分词: listed 第三人称单数: lists
log	                            日志  n. 原木，圆材；正式记录，航海日志；对数；（定期或系统的）观察记录；船舶测速仪 v. 正式记录；行驶，行进（若干距离或时间）；伐木，砍伐；<美>成功获得，取得（成就）  复数: logs 过去式: logged 现在分词: logging 过去分词: logged 第三人称单数: logs
Logger	                        日志记录器  n. （美）樵夫，伐木工；记录器  复数: loggers
login	                        登录  n. [计]进入系统 vt. [计]登录；注册 vi. [计]登录；注册 n. （Login）人名；（英、俄、匈、罗）洛金
login Time	                    登录时间
logo	                        标志  n. （公司或组织的）标识，徽标 n. （Logo）（美）洛戈（人名）  复数: logos
long	                        长  adj. 长的；长久的，长期的；漫长的；长篇的；长音的；出界的；（面部表情）不高兴的，愁苦的；记得牢的，记得久的；（可能性，机会）小的，渺茫的；远期（获利）的；（酒与凉饮料）混合的，大量的；（运动中的球）长传的，远距离的 adv. 长久地，长期地；很久（以前或以后）；整个（时间段）；（球扔得）远；整个 (时间段) v. 渴望 n. 长时间，长时期；长音；远期证券；长期资本 【名】 （Long）（美、英、爱）隆（人名）  复数: longs 过去式: longed 比较级: longer 最高级: longest 现在分词: longing 过去分词: longed 第三人称单数: longs
longitude	                    经度  n. 经度，经线  复数: longitudes
Mapped Superclass	            映射的超类
margin	                        保证金  n. 页边空白；差额，幅度；盈余，利润；余地，备用的时间（或空间、金钱等）；边缘，非主体部分；保证金，押金；<澳新>额外报酬 v. 给……加上边；预付定金，交押金；<古>页边做注释或总结 【名】 （Margin）（俄、意）马尔金（人名）  复数: margins 过去式: margined 现在分词: margining 过去分词: margined 第三人称单数: margins
margin Ratio	                保证金比例  保证金比例：指投资者在进行证券交易时，需要向券商提供的保证金与所购买证券价值之间的比例。
Menu	                        菜单  n. 菜单；饭菜，菜肴；（电脑屏幕上的）菜单，功能选择单  复数: menus
menu Code	                    菜单的代码
menu Icon	                    菜单图标
menu Name	                    菜单名称
menu Sort	                    菜单排序
menu Title	                    菜单标题  菜单标题：显示在菜单顶部的文字，通常用于描述菜单的内容或功能。 · Please choose a suitable menu title for the new restaurant. 请为新餐厅选择一个合适的菜单标题。
message	                        消息  n. 口信，消息；（书籍、演讲等的）要旨，主题思想；（从大脑发给身体某部位或身体某部位向大脑发送的）信息；购物；<美>电视广告；<英>差使；启示，教训；（先知的）预言 v. （尤指以电子形式）传送（信息）；通报  复数: messages 过去式: messaged 现在分词: messaging 过去分词: messaged 第三人称单数: messages
MOBILE	                        移动  adj. 活动的，可移动的；行动方便的，行动自如的；流动性强的；（面部表情）易变的，多变的；机动的，车载的；与移动电话（或掌上电脑等技术）有关的 n. 活动的装饰品，悬挂饰物；移动电话  复数: mobiles 比较级: more mobile 最高级: most mobile
name	                        名字  n. 名字，名称；名声，名誉；<非正式>名人，有名的事物；（侮辱人的）绰号，别称；（英国）属劳埃德保险社辛迪加的承保人 v. 命名，给……取名；说出……的名称，叫出……的名字；说定，确定；任命，委任；<英>（下议院议长）点名开除（立法委员会成员）的议员身份 adj. 有名的，出名的；姓名的，据以取名的 【名】 （Name）内姆（日）滑（姓）（人名）  复数: names 过去式: named 现在分词: naming 过去分词: named 第三人称单数: names
news Type	                    消息类型  新型：指一种新的、与以往不同的类型、种类或形式。
Not Null	                    非空
null	                        零  adj. 无约束力的，无效的；零值的，等于零的；（数）（集合，矩阵）空的，元素只有零的；无特征的，无内涵的 n. <文>零；（密码中的）无意义暗码；（电子）无信号；无电磁辐射的方向 v. 使（信号）与另一信号结合产生无信号状态，抵消
nullable	                    可以为空  可为空的
office Address	                办公地址  办公地址：一个人或组织的办公地点，通常用于邮寄、联系或访问。 · Please send the documents to our office address. 请将文件寄到我们的办公地址。
OPERATE FAIL	                操作失败
Order	                        订单  n. 命令，指示；顺序，次序；井然有序，整齐；正常工作状况，良好使用状况；秩序，治安；（社会的）制度，结构；社会阶级；<正式>种类，类别；点餐，订购；点的餐，订购的货物；（饮食）分量；法院决议，法官指令；汇票，书面指令；（会议、议会、辩论或法院的）程序，规程；（宗教）仪式，祭礼；宗教团体，（尤指）修道会；兄弟会，会社；（尤指主教、牧师、执事的）品级，神品；圣职，牧师职（orders）；（神学）（九级天使的）级；<史>骑士团；勋位，勋爵士团；勋章；（动植物）目；柱型，装饰样式（多利斯、爱奥尼亚、科林斯、托斯卡那和混合型等五种古典建筑风格之一）；建筑类型，样式；（军）专用装备，专用服装；立正持枪姿势（the order）；（数）阶；方程的阶；群阶；矩阵的阶；<美>（计算机的）任务排序，等待队列 v. 命令，指示；就……下令；订购，订货；（为某人）叫出租车；点（菜），点（饮料）；排列，整理  复数: orders 过去式: ordered 现在分词: ordering 过去分词: ordered 第三人称单数: orders
order Number	                订单号  订单号：一串数字或字母，用于唯一标识一笔交易或订单。
ORGANIZATION	                组织  n. 组织，机构；组织工作，筹备工作；编排，配置，结构；条理，逻辑性；机化  复数: organizations
Owner	                        老板  n. 所有人，物主  复数: owners
package	                        包  n. 包裹；<美>（包装食物等的）盒，包；（建议或提供的想法或服务的）一套，一揽子；包价（旅游）；成套出售的东西，套餐；软件包 v. 把……打包，把……装箱（以便出售）；包装（产品或想法等）；配套销售（商品）；承揽图书（尤指插图多的图书）的约稿和印制并整体打包出售给出版商  复数: packages 过去式: packaged 现在分词: packaging 过去分词: packaged 第三人称单数: packages
pageable	                    可分页  可调页的
param Map	                    参数映射
PASSED	                        通过了  adj. 已经通过的；已经过去的；已被传递的 v. 经过；穿过；绕；传递；转给（pass 的过去式和过去分词）
password	                    密码  n. 密码；口令，暗语  复数: passwords
Path	                        路径  n. 小径，小道；（开出的）通道；（事物或人移动的）路线，轨迹；（有助于实现某事的）道路，途径；通勤火车时刻表；（计算机）路径  复数: paths
pay Amount	                    支付金额  支付金额：指在购买商品或服务时需要支付的款项。
payee	                        收款人  n. 领款人，收款人  复数: payees
payee Account	                收款人账户
payee Bank	                    收款人银行
payee Id	                    收款人身份证
payer	                        付款人  n. 付款人；支付者 n. （Payer）人名；（法）佩耶；（英）帕耶；（德、捷）派尔  复数: payers
payer Account	                付款人账户
payer Bank	                    付款人银行
payer Id	                    付款人身份
PENDING	                        等待  adj. 待决的，待定的，待处理的；即将发生的，迫近的 prep. 直到……为止，在……之前，在等待……之际 v. 等候判定或决定（pend的现在分词） 【名】 （Pending）（瑞典）彭丁（人名）
PERMISSION	                    许可  n. 同意，许可；许可证，书面许可  复数: permissions
permit	                        许可证  v. 批准，许可；（使）成为可能；破例做，放纵 n. 执照，许可证；古氏鲳鲹  复数: permits 过去式: permitted 现在分词: permitting 过去分词: permitted 第三人称单数: permits
PERSONAL	                    个人  adj. 个人的，私人的；私密的，隐私的；针对个人的，人身攻击的；人身的，身体的；人际的，私交的；供个人使用的；亲自的；有人性的；（语法）人称的 n. （报纸私人广告栏内的）私人信息发布，私人广告；（报纸或杂志上的）个人启事栏，私人广告栏（the personals）  复数: personals 比较级: more personal 最高级: most personal
phone	                        电话  n. 电话，电话系统；受话器，听筒；（语音）音子，音素 v. 给…...打电话 【名】 （Phone）（老、缅）蓬（人名）  复数: phones 过去式: phoned 现在分词: phoning 过去分词: phoned 第三人称单数: phones
phone Number	                电话号码  电话号码：一串数字，用于拨打电话以联系某人或某个地方。
PLATFORM NAME	                平台名称
price	                        价格  n. 价格；代价；开价，价码；投注赔率；<古> 价值 v. 为……定价；给（商店中的产品）标价；比较……的价格；问……的价格 【名】 （Price）（英）普赖斯，（法）普里斯，（葡、瑞典）普里塞（人名）  复数: prices 过去式: priced 现在分词: pricing 过去分词: priced 第三人称单数: prices
print Stack Trace	            打印堆栈跟踪
private	                        私人  adj. 私有的，自用的；（服务，行业）私营的，民营的；没有股票上市的；私下的，秘密的；（交易未涉及商业机构的）私下里的；（想法、感觉）私密的；未担任公职的，无官职的；与官职（或工作）无关的；安静的，不受打扰的；（人）内敛的，不喜欢谈论私事的；（尤指两人）单独的；私下辅导的；（教育，医疗）私立的；只有自己人明白的 n. （美、英陆军或美国海军陆战队）二等兵；<非正式> 私处，阴部（privates）  复数: privates 比较级: more private 最高级: most private
project Snapshot Id	            项目快照Id
Properties	                    属性  n. <正式>房屋及周围的土地；性质，性能；（舞台或电影的）道具（prop 的旧时用语）（property 的复数）
province	                    省  n. （知识、兴趣、责任的）范围，领域；省；（由大主教负责管辖的）教省；外省，外地（the provinces）；<英> 北爱尔兰（the Province）；（古罗马总督统治的意大利境外的）行省  复数: provinces
public	                        公共  adj. 公众的，大众的；公共的，公用的；政府的，公众事务的；<英> 大学的，为大学的；（声明、事件等）公开的，公诸于众的；公开场合的，大庭广众的；上市的；众所周知的，广为人知的 n. 公众，大众（the public）；志趣相投（或从事同一类活动、具有共同特征）的群体；<非正式>（对某个艺术家、作家或表演家感兴趣的）读者，观众（one's public）；<英>（酒馆中的）低价吧台（=public bar），酒吧（=public house）；公共场所 【名】  （Public）（英）帕布利克（人名）  复数: publics
publish Time	                发布时间
Query	                        查询  n. 疑问，询问；问号 v. 质疑，对……表示疑问；询问，提问  复数: queries 过去式: queried 现在分词: querying 过去分词: queried 第三人称单数: queries
Reason	                        原因  n. 原因，理由；充分理由，正当理由；道理，情理；判断力，理智 v. 推理，逻辑思考；推论出，推断出（reason sth. out）；对（某人）以理相劝，劝告（reason with） 【名】 （Reason）（英）里森（人名）  复数: reasons 过去式: reasoned 现在分词: reasoning 过去分词: reasoned 第三人称单数: reasons
receipt Info	                收到信息
regist	regist                  abbr. 注册（register）
Repository	                    存储库  n. 贮藏室，仓库；自然资源丰富的地区；（电脑）数据库；喻为知识宝库的人（或物）  复数: repositories
request Param	                请求参数
required	                    要求  adj. 必需的，规定的；理想的 v. 需要；要求做（某事），规定（require 的过去式和过去分词形式）；要求做（某事），规定（require 的过去式和过去分词）
reset Password	                重置密码  重置密码
resolve	                        解决  v. 解决（问题或困难）；决定，下定决心；作出决议，表决；分解，转化；（使）（症状、病情）消散，消退；解析，解离；分析；（不协和音）转向协和；（当远处物体看得更清楚时）变成；（光学仪器等）分辨；辨析（图表或光谱峰值） n. <正式>决心，坚定的信念；<美>正式决定，决议；决定要做的事  复数: resolves 过去式: resolved 现在分词: resolving 过去分词: resolved 第三人称单数: resolves
response Data	                响应数据  [计] 响应数据
result	                        结果  n. 结果，后果；（比赛或选举的）结果；（通过调查、研究、计算而获得的）结果；<英> 考试成绩；成效，成果（results）；经营业绩（results）；<英，非正式>（体育比赛中）胜局，获胜 v. 发生，产生；导致，造成（注明的结局或结果） int. <非正式> 成功了！（Result!）  复数: results 过去式: resulted 现在分词: resulting 过去分词: resulted 第三人称单数: results
return	                        返回  v. 回来，回去；归还，退还；回报，回应；（感觉或情况）重新出现，恢复；重新开始，继续（某项活动）；带来，产生（利润或损失）；回击，击回；宣告（裁决）；选举，选出；（建筑）（尤指成直角）转延（墙壁）；（高尔夫）打后九穴；（美橄）截获（对方传、踢或漏球）反攻；（桥牌）（尤指同伴所攻出的同花色牌赢墩后）跟着打出，回出；把（空瓶或空罐头盒）送到回收站 n. 回来，返回；归还，退回；重新开始，恢复；回报，收益；<英> 往返票，来回票；返回键，回车键；（选举）结果；（网球等）回击球；（纳税）申报表，申报单；（建筑）转延，转延侧面；回路导线；被退回（或送回）的东西，退票；（可以回收的）空罐头盒，空瓶子（returns） adj. （票）双程的，往返的；（旅途）返回的，返程的；（比赛）回访的；再度的，再次的  复数: returns 过去式: returned 现在分词: returning 过去分词: returned 第三人称单数: returns
Role	                        角色  n. （演员的）角色；作用，职责 【名】 （Role）（意、塞、赤几）罗莱（人名）  复数: roles
role Code	                    角色代码
save	                        保存  v. 救助，搭救；避免，减少；积攒，储蓄；节省（钱、时间或其他资源）；保存，保留；收集；（为某人）保留；（计算机）保存（数据）；使健康长寿，护佑；（足球等）救球，防止对方进球；（棒球）（替补投手） 保持（其他投手取得的领先地位）；（基督教）拯救（某人），使摆脱罪孽 n. （足球等守门员的）救球；（棒球）（替补投手） 保持（其他投手取得的领先地位）；（计算机）存储数据 prep. <正式> 除……之外 【名】 （Save）（法）萨夫，（意、保、西、罗、塞、瑞典）萨薇 （女名），萨韦（人名）  复数: saves 过去式: saved 现在分词: saving 过去分词: saved 第三人称单数: saves
Schema	                        模式  n. （计划或理论的）纲要，图解；（逻）（三段论法的）格；（康德哲学的）先验图式  复数: schemata, schemas
Security Configurer Adapter	    安全配置适配器
seller Name	                    卖方名称
send	                        发送  v. 邮寄，发送；传达，告知；派遣，打发，安排去；使快速（或猛然）移动；使作出（某种反应），使表现出（某种行为）；排放，排出（烟或化学反应的产生物等）；<非正式> 使着迷，使入迷 n. <古> 波浪的推力，波浪引起的水位上升（=scend） 【名】 （Send）（德）森德  过去式: sent, sended 现在分词: sending 过去分词: sent, sended 第三人称单数: sends
Serializable	                可序列化的  adj. 可串行化的
shop Id	                        商店Id
shop Name	                    商店的名字  商店名称：一家商店或商业场所的名称，用于标识和区分不同的商店。 · The shop name should be unique and attractive to customers. 商店名称应该独特且吸引顾客。
sign Up	                        报名  注册：在某个网站、活动或组织中登记个人信息以成为会员或参与者。
Signed	                        签署  adj. 有符号的；已签字的；有正负之分的 v. 署名；写下；预示；示意（sign 的过去分词）
slogan	                        口号  n. 口号，标语；广告语；<史>苏格兰高地的战斗呐喊  复数: slogans
sms	                            短信
sms Log Type	                短信日志类型
start Time	                    开始时间  开始时间：指某个活动、事件或任务的预定或实际开始的时刻。
static	                        静态  adj. 静止的，停滞的；静电的；静力的；（计算机）（储存器，储存）静态的；（计算机）（程序，变量）静态的；（物理）（物体）静止的，不动的 n. 静电；（广播、电视里的）静电噪声，静电干扰；<美，非正式>不停的抱怨，指责；静力学
Status	                        状态  n. 法律地位（或身份）；（尤指在社会中的）地位，身份；高级职位，社会上层地位；重视（或崇尚）程度；状况，情形  复数: statuses
strategy	                    策略  n. （尤指为获得某物制定长期的）策略，行动计划；战略，战略学  复数: strategies
Stream	                        流  n. 小河，小溪；一连串，源源不断（的事情）；（烟、气、液体的）流，股；（同龄学生按能力划分的）班，组；音像流；数据流，指令流 v. （人，东西）流动，涌动；不断地流出（液体），不断地排出（气体）；（光线）照射，照耀；（尤指在风中或水中）飘动，流动；在线收听（或收看）；按能力分班（或分组）  复数: streams 过去式: streamed 现在分词: streaming 过去分词: streamed 第三人称单数: streams
String	                        字符串  n. 线，细绳；一连串，一系列（事件）；一系列（类似的事物）；字符串，信息串；一串；弦；弦乐器，弦乐组；（网拍的）羊肠线，网线；（球队中按技术水平分编的）小队；特定条件（或限制）；（类似细绳的）细长物；（同一训马场训练的）一群赛马；（按先后顺序排列的）后备队，候补队员；（墙网球等）处于特定排位的队员；（蔬菜、肉等食物的）纤维，（豆荚等的）筋，络；一种假设的亚原子粒子；G弦；宇宙弦；楼梯侧基板（stringboard 的简称） v. 用线穿，串起；使排成一排，把……连在一起；悬挂，系，扎；给（乐器或球拍）串弦；去掉（豆荚）的筋；当特约记者；确定击球顺序；拖延……的时间；<美，非正式>欺骗 adj. 由弦乐器组成的，弦乐器的；线织的，线的  复数: strings 过去式: strung 现在分词: stringing 过去分词: strung 第三人称单数: strings
succeed	                        成功  v. 成功，达成；（学业、事业或其他活动）表现出色，有作为；取得预期效果，表现良好；继任，接任；接替，随后出现；结果却是……；若一次不成功，要再接再厉  过去式: succeeded 现在分词: succeeding 过去分词: succeeded 第三人称单数: succeeds
switch	                        开关  n. 开关，电闸；骤变，突变；交换机；（计算机）切换；<美> （铁路的）转辙器，道岔；（细软的）枝条，鞭子；假发；（在英国使用借记卡付账的一种）转换系统（Switch） v. （用开关）打开，关闭；（使）改变，转变；交换，调换；转移（注意力）；（与某人）交换工作，调班；<古> 用枝条击打，轻拂  复数: switches 过去式: switched 现在分词: switching 过去分词: switched 第三人称单数: switches
sys Add	                        系统添加
Table	                        表格  n. 桌子，枱子；谈判桌；（就餐或玩牌等的）一桌人；一桌酒席，饭菜；（饭后）清理餐桌，整理餐桌；（饭前）摆放餐具；列表，一览表，表格；（竞赛等的）名次表，排名榜，积分表；乘法表；（计算机）表；（桥牌）明手，明家；（建筑）檐板；木匾，石碑；（宝石的）切平面；有双切平面的宝石；（巴加门15子棋可折叠的半面或四分之一的）棋盘；水平模制（尤指檐口） v. <英> 正式提出，提交（议案）；<美> 搁置，暂缓审议；用宽贴边加固（帆）  复数: tables 过去式: tabled 现在分词: tabling 过去分词: tabled 第三人称单数: tables
template	                    模板  n. （用于切割木材、纸、金属等的）模板；（计算机文档的）模板；样板，榜样；（生化）模板；承梁短板，垫木，垫板  复数: templates
template Code	                模板代码  模板码
title	                        标题  n. （书籍、诗歌、图画、乐曲等的）名称，标题；（书刊的）一种，一本；（人名前表示地位、职业或婚姻状况的）头衔，称谓；职位名称；称号；（竞赛、体育比赛的）冠军；（尤指土地或财产的）所有权；（财产的）所有权凭证；（电影、电视的）字幕；（教会用语）就任圣职需具备的资格；（罗马红衣主教下辖的）教区，教堂 v. （给书籍、乐曲等）加标题，定题目；赋予头衔，把……称为 adj. 与（电影、戏剧等）同名的；冠军的  复数: titles 过去式: titled 现在分词: titling 过去分词: titled 第三人称单数: titles
token	                        令牌  n. （某些机器中用以代替纸币的）代币，专用辅币；象征，标志；礼券，代金券；（语言学）符号；（计算机）令牌，记号；（火车通行的）路签 adj. 装点门面的，装样子的；象征性的，作为标志的  复数: tokens
total Price	                    总价格  总价：指购买商品或服务时所需支付的全部费用。
true	                        真正的  adj. 真实的；正确的 adv. 真实地；准确地 n. 真实；准确 vt. 装准 n. （True）(英)特鲁（人名）  过去式: trued 比较级: truer, more true 最高级: truest, most true 现在分词: truing, trueing 过去分词: trued 第三人称单数: trues
try	                            试一试  v. 试图，努力；试用，试做，试验；品尝；考验，磨炼；到（某处）试试，找一找；试着打开（门、窗等）；审理，审判；用刨子刨平（木头粗糙面）；加热以提取（油，脂肪），熬（油） n. 试图，努力；试用，试验；（橄榄球）持球触地得分 【名】 （Try）（英、印尼）特里，（柬）德里（人名）  复数: tries 过去式: tried 现在分词: trying 过去分词: tried 第三人称单数: tries
type	                        类型  n. 类型，种类；具有某种特征的人，典型；（印刷的）文字，字体；（印刷）铅字，活字；象征；（艺术的）典型，榜样；（宗教学）预兆；（植，动）型，模式标本；（奖章或硬币）图案；（语言学）类型，型 v. （用计算机或打字机）打字；测定……的类型，分型 【名】 （Type）（英）泰普（人名）  复数: types 过去式: typed 现在分词: typing 过去分词: typed 第三人称单数: types
UNPASSED	                    UNPASSED   adj. 未通过的
upload	                        上传  v. 上载，上传 n. 上载（上传）的内容，上传
USER	                        用户  n. 用户；使用者 n. （User）（土）乌塞尔（人名）  复数: users
User Type	                    用户类型  用户类型
validate	                    验证  v. 批准，确认……有效；证实，确认；使生效，使具有法律效力；证明有……价值，认可  过去式: validated 现在分词: validating 过去分词: validated 第三人称单数: validates
value	                        价值  n. 价值；等值，等价，物有所值；重要性，有用性；重要特点，显著特点；价值观（values）；（数学中的）值；（音乐中的）时值（指音符的时间长度）；（词或其他语言单位）确切意义；（色彩）明暗度 v. 尊重，重视；给……估价，给……定价  复数: values 过去式: valued 现在分词: valuing 过去分词: valued 第三人称单数: values
Verified Status	                验证状态
verify Unpassed Reason	        验证未通过原因
VERIFYING	                    验证  v. 验证；核查（verify 的 ing 形式）
visit Date	                    访问日期  参观日期：预定参观某个地方或活动的具体日期。 · Please confirm your visit date to the museum in advance. 请提前确认您参观博物馆的日期。
visit Time	                    访问时间  拜访时间
Visit Track	                    访问记录
void	                        无效  n. 空间，空白，空虚；空虚感，失落感；（墙、建筑物上的）孔隙；（桥牌和惠斯特用语）缺门 adj. 不合法的，无效的；（话语，行动）无效的，无用的；毫无……的，缺乏……的；空的，空空如也的；<正式>（职位）空缺；（桥牌和惠斯特用语）缺门的 v. 使无效，使作废；排泄，排放（大小便）；排放（水、气体等）；倒空（容器），疏空（空间）  复数: voids 过去式: voided 现在分词: voiding 过去分词: voided 第三人称单数: voids
website	                        网站  n. 网站（全球资讯网的主机站）  复数: websites
zip Code	                    邮政编码  n. 邮政编码